21111111111111111111111111111111111111111111111112
10000000000000000000000000000000000000000000000001
10000000000000000000000000000000000000000000000001
10000000000000000000000000000000000000000000000001
10000000000000000000000000000000000000000000000001
10000000000000000000000000000000000000000000000001
10000000000000000000000000000000000000000000000001
10000000000000000000000000000000000000000000000001
10000000000000000000000000000000000000000000000001
10000000000000000000000000000000000000000000000001
10000000000000000000000000000000000000000000000001
10000000000000000000000000000000000000000000000001
10000000000000000000000000000000000000000000000001
10000000000000000000000000000000000000000000000001
10000000000000111111111111111111111100000000000001
10000000000000100000000000000000000100000000000001
10000000000000100000000000000000000100000000000001
10000000000000100000000000000000000100000000000001
10000000000000100000000000000000000100000000000001
10000000000000100000000000000000000100000000000001
10000000000000100000000000000000000100000000000001
10000000000000100000000000000000000100000000000001
10000000000000100000000000000000000100000000000001
10000000000000100000000000000000000100000000000001
10000000000000100000000000000000000100000000000001
10000000000000100000000000000000000100000000000001
10000000000000100000000000000000000100000000000001
10000000000000100000000000000000000100000000000001
10000000000000100000000000000000000100000000000001
10000000000000100000000000000000000100000000000001
10000000000000100000000000000000000100000000000001
10000000000000100000000000000000000100000000000001
10000000000000100000000000000000000100000000000001
10000000000000100000000000000000000100000000000001
10000000000000111111111111111111111100000000000001
10000000000000000000000000000000000000000000000001
10000000000000000000000000000000000000000000000001
10000000000000000000000000000000000000000000000001
10000000000000000000000000000000000000000000000001
10000000000000000000000000000000000000000000000001
10000000000000000000000000000000000000000000000001
10000000000000000000000000000000000000000000000001
10000000000000000000000000000000000000000000000001
10000000000000000000000000000000000000000000000001
10000000000000000000000000000000000000000000000001
10000000000000000000000000000000000000000000000001
10000000000000000000000000000000000000000000000001
10000000000000000000000000000000000000000000000001
10000000000000000000000000000000000000000000000001
21111111111111111111111111111111111111111111111112